11111111111
10000PCE001
11111111111
