11111111111
1E000P00C01
11111111111
