11111111111
10000P00001
1CCCCCCCC01
10000000001
100E0000001
10000000001
100000C0001
11111111111